32
1 66 2 
2 63 6 
3 85 6 60 10 75 2 
4 75 8 2 6 
5 62 3 
6 74 6 
7 2 2 
8 65 8 93 10 66 5 
9 71 7 
10 71 3 69 10 98 1 
11 27 5 29 10 84 10 73 10 19 10 74 2 
12 97 10 92 5 
13 91 4 
14 63 2 
15 52 8 95 10 82 8 
16 91 3 
17 54 8 0 7 
18 64 9 56 10 87 10 61 10 72 10 85 4 
19 92 5 68 10 1 10 94 10 91 3 
20 74 2 79 7 
21 82 2 55 10 77 10 86 10 58 10 78 10 4 10 53 6 
22 0 3 88 10 70 10 83 10 3 10 89 4 
23 59 9 65 2 
24 63 2 59 1 
25 2 2 
26 54 2 
27 89 6 99 10 52 2 
28 66 3 67 10 62 7 
29 98 9 96 10 90 10 57 10 64 1 
30 53 4 27 5 
